11111111
100P0001
10C0C0C1
10101011
10100001
1CC000E1
11111111
