11111111
100P0001
10C0C0C1
10101011
1110001
1C0000E1
11111111
