11111111111111111
100P00000000001C1
10C0C0C0000000101
1011100000C000101
10000110001110001
1C0011E000CC01101
11111111111111111