11111111
100P0001
10C0C0C1
10101011
10101001
1C1E1CC1
11111111