11111111
100P0001
10C0C0C1
10101011
11101111
1C0ECCC1
11111111
