111111111111111111111111
100P00010000000000000C11
10C0C0C00000000001CC1111
101010100000000001CCC001
111000110011111001000001
1C0000E11111111111000001
111111111111111111111111
